                               
           P                   
                               
                  ####         
                  ########     
                    ####       
   #####                       
   #####        ##             
 ########       #####          
 ########        ####          
  #####                        
  #####               S        
   ##                ###       
                     ###       
                               
            ######             
             ###########       
        S    #########         
       ##########              