         ###          ##       
         ###          ##       
                               
#G                             
###      P                     
                 ###           
                  ##           
                   #           
    ###                   ##   
    ###        ##         ##   
               #######  ####   
                 #####  #####  
                  ##      ###  
     ##           ##           
#######                        
###########               #####
###########G           S  #####
###############################
###############################