XXXXXXXXXXXXXXXXXXXXXXXXXXX   XXXXXXXXXXXXXXXXXXXXXXXXXXXXXXXXXXXXXXXXXXXXXXXXXXXXXXXXXXXXXXXXXXXXXXXXXXXXXXXXXXXXXXXXXXXXXXXXXXXXXXXX
XXXXXXXXXXXXXXXXXXXX             XXXXXXXXXXXXXXXXXXX                                      XXXX         XXXXXXXX     XXXXXXXXXXXXXXXXXX
XXXXXXXXXXXXXXXXXXXX        P    XXXX                       G                             XXXX  C       XXXXX       XXXXXXXXXXXXXXXXXX
XXXXXXXXXXXXXXXXXX               XXXX                   XXXXX              XX             XXXXXXXXX     XXXXX    XXXXXXXXXXXXXXXXXXXXX
XXXXXXXXXXXXXXXXXX         XXXXXXXXXX                   XXXXX          XXXXXX             XXXXXXXXXXX          XXXXXXXXXXXXXXXXXXXXXXX
XXXXXXXXXXXXXXXXXX  XXX u  XXXXXXXXXX   XXXXXXXXXXXXXXXXXXX            XX        XXXXXX    XXXXXXXXXX          XXXXXXXXXXXXXXXXXXXXXXX
XXXXXXXXXXXXXXXXXX  XXX                 XXXXX         XXXXX     XX               XXXXXX    XXXXXXXX     XXXXX  XXXXXXXXXXXXXXXXXXXXXXX
XXXXXXXXXXXXXXXXXX  XXXXX                                       XXXXX            XXXXXX      XXXXXX     XXXXX    XXXXXXXXXXXXXXXXXXXXX
XXXXXXXXXXXXXXXXXX  XXXXX     XXXX       C                      XXXXX          XXXXXXXXXX    XXXXXX   XXXXXXX    XXXXXXXXXXXXXXXXXXXXX
XXXXXXXXXXXXXXXXX     XXXX    XXXX      XXXX          XXXXX       XXX          XXXXXXXXXX             XXXXXXXXX    XXXXXXXXXXXXXXXXXXX
XXXXXXXXXXXXXXXXX     XXXXL   XXXXXX    XX     XXXX   XXXXX       XXXC            XXXXXXXX            XXX  XXXX    XXXXXXXXXXXXXXXXXXX
XXXXXXXXXXXXXXXXXX   XXXXXXX   XXXXX           XXXX     XXX       XXXXXXXX           XXXXX  XXXXXXX              XXXXXXXXXXXXXXXXXXXXX
XXXXXXXXXXXXXXXXXX   XXXXXXX   XXXX                     XXX     XXXXXXXXXX                  XXXXXXX              XXXXXXXXXXXXXXXXXXXXX
XXXXXXXXXXXXXXXXXX     XXX                                      XXXXXXXX         XX         XXXXXXXXXXX    XXXXXXXXXXXXXXXXXXXXXXXXXXX
XXXXXXXXXXXXXXXXXX                   B                          XXXXXX           XX            XXXXXXXX    XXXXXXXXXXXXXXXXXXXXXXXXXXX
XXXXXXXXXXXXXXXXXXXX          XXXXXXXXXX         XXXXX        XXXXXXXX           XXXX            XXXXXX  XXXXXXXXXXXXXXXXXXXXXXXXXXXXX
XXXXXXXXXXXXXXXXXXXXY       XXXXXXXXXXXXXX     XXXXXXX        XXXXXXXXXX         XXXX        V   XXXXXX  XXXXXXXXXXXXXXXXXXXXXXXXXXXXX
XXXXXXXXXXXXXXXXXXXXXXXXX   XXXXXXXXXXXXXX     XXXXXXXXX      XXXXXXXXXXXXXXXX   XXX      XXXXXXXXXXXXX  XXXXXXXXXXXXXXXXXXXXXXXXXXXXX